wwwwwwwwwwwwwwwwwwwwwwwwwwwwwwww
w                              w
w   b              w           w
w                              w
w                  w           w
w                  w         w w
w                  w           w
w    s             w          ww
w         b        w           w
w                  w          ww
w                              w
w         b        w          ww
w                  w          ww
w            b     w b        ww
w                  bbbbbbbbbbbww
w                  wbbbbbbbbbbww
w                  wwwwwwwwwwwww
wwwwwwwwwwwwwwwwwwwwwwwwwwwwwwww
