wwwwwwwwwwwwwwwwwwww
w   s              w
w   b              w
w                  w
w                  w
w                  w
w                  w
w                  w
w                  w
w                  w
w                  w
w                  w
w                  w
w                  w
w                  w
w                  w
w                  w
w                  w
w                  w
wwwwwwwwwwwwwwwwwwww